#####################################
#....##...##.##..#.############...###
##.####.#.....##.#............###.###
#.......#.##.###.#.####.##.######.###
###.##.#####.#...#.####.*..##......##
##..#..#.......###.##...#######.#####
##.###.#.###.#.....##.######....##..#
##.##....##..########....##..##....##
##.########.############....######..#
#................##########..######..
#####################################